#time,date,susceptible,exposed,infectious,recovered,dead,immune,num infections today,num hospitalisations today,hospital bed occupancy,num hospitalisations today (data),cum num hospitalisations today,cum num infections today
1,2/3/2020,3311,471,542,540,0,0,95,0,8,0.0,0,95
2,3/3/2020,3187,474,571,632,0,0,124,4,11,0.0,4,219
3,4/3/2020,3085,461,592,726,0,0,102,7,18,0.0,11,321
4,5/3/2020,2998,424,626,815,1,0,87,3,20,0.0,14,408
5,6/3/2020,2893,429,624,917,1,0,105,4,24,0.0,18,513
6,7/3/2020,2806,399,645,1013,1,0,87,7,30,0.0,25,600
7,8/3/2020,2706,397,637,1122,2,0,100,6,34,0.0,31,700
8,9/3/2020,2616,386,644,1216,2,0,90,3,37,0.0,34,790
9,10/3/2020,2541,364,615,1341,3,0,75,9,45,0.0,43,865
10,11/3/2020,2475,340,600,1445,4,0,66,6,49,0.0,49,931
11,12/3/2020,2404,311,585,1560,4,0,71,8,51,0.0,57,1002
12,13/3/2020,2352,289,573,1644,6,0,52,3,51,0.0,60,1054
13,14/3/2020,2313,242,567,1736,6,0,39,10,59,0.0,70,1093
14,15/3/2020,2283,202,533,1839,7,0,30,4,59,0.0,74,1123
15,16/3/2020,2245,184,489,1938,8,0,38,1,55,0.0,75,1161
16,17/3/2020,2223,153,455,2022,11,0,22,3,55,0.0,78,1183
17,18/3/2020,2202,129,418,2102,13,0,21,5,55,0.0,83,1204
18,19/3/2020,2184,108,385,2173,14,0,18,5,57,0.0,88,1222
19,20/3/2020,2168,99,328,2254,15,0,16,2,56,0.0,90,1238
20,21/3/2020,2157,73,312,2307,15,0,11,5,57,0.0,95,1249
21,22/3/2020,2148,58,295,2347,16,0,9,9,61,0.0,104,1258
22,23/3/2020,2137,50,265,2396,16,0,11,6,66,0.0,110,1269
23,24/3/2020,2134,40,231,2441,18,0,3,3,64,0.0,113,1272
24,25/3/2020,2132,30,196,2488,18,0,2,4,63,0.0,117,1274
25,26/3/2020,2132,16,167,2530,19,0,0,4,61,0.0,121,1274
26,27/3/2020,2129,13,142,2560,20,0,3,3,57,0.0,124,1277
27,28/3/2020,2127,10,127,2578,22,0,2,1,54,0.0,125,1279
28,29/3/2020,2126,8,110,2596,24,0,1,3,52,0.0,128,1280
29,30/3/2020,2122,9,96,2613,24,0,4,3,51,0.0,131,1284
30,31/3/2020,2122,8,84,2626,24,0,0,1,47,0.0,132,1284
31,1/4/2020,2121,9,72,2637,25,0,1,2,40,0.0,134,1285
32,2/4/2020,2119,11,59,2646,29,0,2,2,37,0.0,136,1287
33,3/4/2020,2118,7,55,2654,30,0,1,0,34,0.0,136,1288
34,4/4/2020,2117,5,43,2669,30,0,1,1,30,0.0,137,1289
35,5/4/2020,2117,4,39,2673,31,0,0,1,27,0.0,138,1289
36,6/4/2020,2117,2,32,2681,32,0,0,1,23,0.0,139,1289
37,7/4/2020,2117,2,26,2686,33,0,0,0,19,0.0,139,1289
38,8/4/2020,2117,1,23,2689,34,0,0,0,16,0.0,139,1289
39,9/4/2020,2117,1,20,2692,34,0,0,0,15,0.0,139,1289
40,10/4/2020,2115,3,17,2693,36,0,2,0,12,0.0,139,1291
41,11/4/2020,2115,3,15,2695,36,0,0,0,11,0.0,139,1291
42,12/4/2020,2115,3,11,2699,36,0,0,0,7,0.0,139,1291
43,13/4/2020,2115,1,12,2700,36,0,0,1,8,0.0,140,1291
44,14/4/2020,2115,0,12,2701,36,0,0,0,8,0.0,140,1291
45,15/4/2020,2115,0,10,2702,37,0,0,0,7,0.0,140,1291
46,16/4/2020,2115,0,8,2703,38,0,0,1,6,0.0,141,1291
47,17/4/2020,2115,0,7,2704,38,0,0,1,6,0.0,142,1291
48,18/4/2020,2115,0,6,2704,39,0,0,0,5,0.0,142,1291
49,19/4/2020,2115,0,5,2705,39,0,0,0,4,0.0,142,1291
50,20/4/2020,2115,0,4,2706,39,0,0,0,3,0.0,142,1291
51,21/4/2020,2115,0,3,2707,39,0,0,0,3,0.0,142,1291
52,22/4/2020,2115,0,3,2707,39,0,0,0,3,0.0,142,1291
53,23/4/2020,2115,0,2,2707,40,0,0,0,2,0.0,142,1291
54,24/4/2020,2115,0,2,2707,40,0,0,0,2,0.0,142,1291
55,25/4/2020,2115,0,1,2708,40,0,0,0,1,0.0,142,1291
56,26/4/2020,2115,0,1,2708,40,0,0,0,1,0.0,142,1291
57,27/4/2020,2115,0,1,2708,40,0,0,0,1,0.0,142,1291
58,28/4/2020,2115,0,1,2708,40,0,0,0,1,0.0,142,1291
59,29/4/2020,2115,0,1,2708,40,0,0,0,1,0.0,142,1291
60,30/4/2020,2115,0,1,2708,40,0,0,0,1,0.0,142,1291
61,1/5/2020,2115,0,1,2708,40,0,0,0,1,0.0,142,1291
62,2/5/2020,2115,0,0,2708,41,0,0,0,0,0.0,142,1291
63,3/5/2020,2115,0,0,2708,41,0,0,0,0,0.0,142,1291
64,4/5/2020,2115,0,0,2708,41,0,0,0,0,0.0,142,1291
65,5/5/2020,2115,0,0,2708,41,0,0,0,0,0.0,142,1291
66,6/5/2020,2115,0,0,2708,41,0,0,0,0,0.0,142,1291
67,7/5/2020,2115,0,0,2708,41,0,0,0,0,0.0,142,1291
68,8/5/2020,2115,0,0,2708,41,0,0,0,0,0.0,142,1291
69,9/5/2020,2115,0,0,2708,41,0,0,0,0,0.0,142,1291
70,10/5/2020,2115,0,0,2708,41,0,0,0,0,0.0,142,1291
71,11/5/2020,2115,0,0,2708,41,0,0,0,0,0.0,142,1291
72,12/5/2020,2115,0,0,2708,41,0,0,0,0,0.0,142,1291
73,13/5/2020,2115,0,0,2708,41,0,0,0,0,0.0,142,1291
74,14/5/2020,2115,0,0,2708,41,0,0,0,0,0.0,142,1291
75,15/5/2020,2115,0,0,2708,41,0,0,0,0,0.0,142,1291
76,16/5/2020,2115,0,0,2708,41,0,0,0,0,0.0,142,1291
77,17/5/2020,2115,0,0,2708,41,0,0,0,0,0.0,142,1291
78,18/5/2020,2115,0,0,2708,41,0,0,0,0,0.0,142,1291
79,19/5/2020,2115,0,0,2708,41,0,0,0,0,0.0,142,1291
80,20/5/2020,2115,0,0,2708,41,0,0,0,0,0.0,142,1291
81,21/5/2020,2115,0,0,2708,41,0,0,0,0,0.0,142,1291
82,22/5/2020,2115,0,0,2708,41,0,0,0,0,0.0,142,1291
83,23/5/2020,2115,0,0,2708,41,0,0,0,0,0.0,142,1291
84,24/5/2020,2115,0,0,2708,41,0,0,0,0,0.0,142,1291
85,25/5/2020,2115,0,0,2708,41,0,0,0,0,0.0,142,1291
86,26/5/2020,2115,0,0,2708,41,0,0,0,0,0.0,142,1291
87,27/5/2020,2115,0,0,2708,41,0,0,0,0,0.0,142,1291
88,28/5/2020,2115,0,0,2708,41,0,0,0,0,0.0,142,1291
89,29/5/2020,2115,0,0,2708,41,0,0,0,0,0.0,142,1291
90,30/5/2020,2115,0,0,2708,41,0,0,0,0,0.0,142,1291
91,31/5/2020,2115,0,0,2708,41,0,0,0,0,0.0,142,1291
92,1/6/2020,2115,0,0,2708,41,0,0,0,0,0.0,142,1291
93,2/6/2020,2115,0,0,2708,41,0,0,0,0,0.0,142,1291
94,3/6/2020,2115,0,0,2708,41,0,0,0,0,0.0,142,1291
95,4/6/2020,2115,0,0,2708,41,0,0,0,0,0.0,142,1291
96,5/6/2020,2115,0,0,2708,41,0,0,0,0,0.0,142,1291
97,6/6/2020,2116,0,0,2707,41,0,0,0,0,0.0,142,1291
98,7/6/2020,2116,0,0,2707,41,0,0,0,0,0.0,142,1291
99,8/6/2020,2116,0,0,2707,41,0,0,0,0,0.0,142,1291
100,9/6/2020,2116,0,0,2707,41,0,0,0,0,0.0,142,1291
101,10/6/2020,2116,0,0,2707,41,0,0,0,0,0.0,142,1291
102,11/6/2020,2116,0,0,2707,41,0,0,0,0,0.0,142,1291
103,12/6/2020,2117,0,0,2706,41,0,0,0,0,0.0,142,1291
104,13/6/2020,2117,1,0,2705,41,0,1,0,0,0.0,142,1292
105,14/6/2020,2117,1,0,2705,41,0,0,0,0,0.0,142,1292
106,15/6/2020,2117,1,0,2705,41,0,0,0,0,0.0,142,1292
107,16/6/2020,2118,0,1,2704,41,0,0,0,0,0.0,142,1292
108,17/6/2020,2118,0,1,2704,41,0,0,0,0,0.0,142,1292
109,18/6/2020,2118,0,1,2704,41,0,0,0,0,0.0,142,1292
110,19/6/2020,2119,0,1,2703,41,0,0,0,0,0.0,142,1292
111,20/6/2020,2119,0,1,2703,41,0,0,0,0,0.0,142,1292
112,21/6/2020,2120,0,1,2702,41,0,0,0,0,0.0,142,1292
113,22/6/2020,2121,0,0,2702,41,0,0,0,0,0.0,142,1292
114,23/6/2020,2121,0,0,2702,41,0,0,0,0,0.0,142,1292
115,24/6/2020,2124,0,0,2699,41,0,0,0,0,0.0,142,1292
116,25/6/2020,2125,0,0,2698,41,0,0,0,0,0.0,142,1292
117,26/6/2020,2125,0,0,2698,41,0,0,0,0,0.0,142,1292
118,27/6/2020,2126,0,0,2697,41,0,0,0,0,0.0,142,1292
119,28/6/2020,2126,0,0,2697,41,0,0,0,0,0.0,142,1292
120,29/6/2020,2126,0,0,2697,41,0,0,0,0,0.0,142,1292
121,30/6/2020,2127,0,0,2696,41,0,0,0,0,0.0,142,1292
122,1/7/2020,2128,0,0,2695,41,0,0,0,0,0.0,142,1292
123,2/7/2020,2128,0,0,2695,41,0,0,0,0,0.0,142,1292
124,3/7/2020,2128,0,0,2695,41,0,0,0,0,0.0,142,1292
125,4/7/2020,2128,0,0,2695,41,0,0,0,0,0.0,142,1292
126,5/7/2020,2128,0,0,2695,41,0,0,0,0,0.0,142,1292
127,6/7/2020,2129,0,0,2694,41,0,0,0,0,0.0,142,1292
128,7/7/2020,2130,0,0,2693,41,0,0,0,0,0.0,142,1292
129,8/7/2020,2133,0,0,2690,41,0,0,0,0,0.0,142,1292
130,9/7/2020,2134,0,0,2689,41,0,0,0,0,0.0,142,1292
131,10/7/2020,2134,0,0,2689,41,0,0,0,0,0.0,142,1292
132,11/7/2020,2134,0,0,2689,41,0,0,0,0,0.0,142,1292
133,12/7/2020,2135,0,0,2688,41,0,0,0,0,0.0,142,1292
134,13/7/2020,2137,0,0,2686,41,0,0,0,0,0.0,142,1292
135,14/7/2020,2139,0,0,2684,41,0,0,0,0,0.0,142,1292
136,15/7/2020,2139,0,0,2684,41,0,0,0,0,0.0,142,1292
137,16/7/2020,2139,0,0,2684,41,0,0,0,0,0.0,142,1292
138,17/7/2020,2140,0,0,2683,41,0,0,0,0,0.0,142,1292
139,18/7/2020,2140,0,0,2683,41,0,0,0,0,0.0,142,1292
140,19/7/2020,2142,0,0,2681,41,0,0,0,0,0.0,142,1292
141,20/7/2020,2143,0,0,2680,41,0,0,0,0,0.0,142,1292
142,21/7/2020,2146,0,0,2677,41,0,0,0,0,0.0,142,1292
143,22/7/2020,2148,0,0,2675,41,0,0,0,0,0.0,142,1292
144,23/7/2020,2148,0,0,2675,41,0,0,0,0,0.0,142,1292
145,24/7/2020,2149,0,0,2674,41,0,0,0,0,0.0,142,1292
146,25/7/2020,2151,0,0,2672,41,0,0,0,0,0.0,142,1292
147,26/7/2020,2153,1,0,2669,41,0,1,0,0,0.0,142,1293
148,27/7/2020,2155,1,0,2667,41,0,0,0,0,0.0,142,1293
149,28/7/2020,2158,0,1,2664,41,0,0,0,0,0.0,142,1293
150,29/7/2020,2161,0,1,2661,41,0,0,0,0,0.0,142,1293
151,30/7/2020,2164,0,1,2658,41,0,0,0,0,0.0,142,1293
152,31/7/2020,2165,0,0,2658,41,0,0,0,0,0.0,142,1293
153,1/8/2020,2167,0,0,2656,41,0,0,0,0,0.0,142,1293
154,2/8/2020,2170,0,0,2653,41,0,0,0,0,0.0,142,1293
155,3/8/2020,2172,0,0,2651,41,0,0,0,0,0.0,142,1293
156,4/8/2020,2174,0,0,2649,41,0,0,0,0,0.0,142,1293
157,5/8/2020,2174,0,0,2649,41,0,0,0,0,0.0,142,1293
158,6/8/2020,2178,0,0,2645,41,0,0,0,0,0.0,142,1293
159,7/8/2020,2180,0,0,2643,41,0,0,0,0,0.0,142,1293
160,8/8/2020,2185,0,0,2638,41,0,0,0,0,0.0,142,1293
161,9/8/2020,2191,0,0,2632,41,0,0,0,0,0.0,142,1293
162,10/8/2020,2195,0,0,2628,41,0,0,0,0,0.0,142,1293
163,11/8/2020,2198,0,0,2625,41,0,0,0,0,0.0,142,1293
164,12/8/2020,2202,0,0,2621,41,0,0,0,0,0.0,142,1293
165,13/8/2020,2207,0,0,2616,41,0,0,0,0,0.0,142,1293
166,14/8/2020,2209,1,0,2613,41,0,1,0,0,0.0,142,1294
167,15/8/2020,2211,1,0,2611,41,0,0,0,0,0.0,142,1294
168,16/8/2020,2216,1,0,2606,41,0,0,0,0,0.0,142,1294
169,17/8/2020,2220,1,0,2602,41,0,0,0,0,0.0,142,1294
170,18/8/2020,2224,0,1,2598,41,0,0,0,0,0.0,142,1294
171,19/8/2020,2229,0,1,2593,41,0,0,0,0,0.0,142,1294
172,20/8/2020,2233,0,1,2589,41,0,0,0,0,0.0,142,1294
173,21/8/2020,2239,0,1,2583,41,0,0,0,0,0.0,142,1294
174,22/8/2020,2244,0,1,2578,41,0,0,0,0,0.0,142,1294
175,23/8/2020,2247,0,1,2575,41,0,0,0,0,0.0,142,1294
176,24/8/2020,2250,0,1,2572,41,0,0,0,0,0.0,142,1294
177,25/8/2020,2259,0,1,2563,41,0,0,0,0,0.0,142,1294
178,26/8/2020,2265,0,0,2558,41,0,0,0,0,0.0,142,1294
179,27/8/2020,2268,0,0,2555,41,0,0,0,0,0.0,142,1294
180,28/8/2020,2271,0,0,2552,41,0,0,0,0,0.0,142,1294
181,29/8/2020,2281,0,0,2542,41,0,0,0,0,0.0,142,1294
182,30/8/2020,2287,0,0,2536,41,0,0,0,0,0.0,142,1294
183,31/8/2020,2290,0,0,2533,41,0,0,0,0,0.0,142,1294
184,1/9/2020,2292,0,0,2531,41,0,0,0,0,0.0,142,1294
185,2/9/2020,2296,0,0,2527,41,0,0,0,0,0.0,142,1294
186,3/9/2020,2304,0,0,2519,41,0,0,0,0,0.0,142,1294
187,4/9/2020,2311,0,0,2512,41,0,0,0,0,0.0,142,1294
188,5/9/2020,2314,0,0,2509,41,0,0,0,0,0.0,142,1294
189,6/9/2020,2320,2,0,2501,41,0,2,0,0,0.0,142,1296
190,7/9/2020,2326,3,0,2494,41,0,1,0,0,0.0,142,1297
191,8/9/2020,2332,3,1,2487,41,0,1,0,0,0.0,142,1298
192,9/9/2020,2337,3,1,2482,41,0,0,0,0,0.0,142,1298
193,10/9/2020,2344,4,1,2474,41,0,1,0,0,0.0,142,1299
194,11/9/2020,2350,3,2,2468,41,0,0,0,0,0.0,142,1299
195,12/9/2020,2364,3,1,2455,41,0,1,0,0,0.0,142,1300
196,13/9/2020,2369,5,1,2448,41,0,2,0,0,0.0,142,1302
197,14/9/2020,2379,3,3,2438,41,0,0,0,0,0.0,142,1302
198,15/9/2020,2394,1,5,2423,41,0,0,0,0,0.0,142,1302
199,16/9/2020,2403,0,6,2414,41,0,0,0,0,0.0,142,1302
200,17/9/2020,2411,0,6,2406,41,0,0,0,0,0.0,142,1302
201,18/9/2020,2425,0,5,2393,41,0,0,0,0,0.0,142,1302
202,19/9/2020,2428,1,5,2389,41,0,1,0,0,0.0,142,1303
203,20/9/2020,2439,1,4,2379,41,0,0,0,0,0.0,142,1303
204,21/9/2020,2453,1,3,2366,41,0,0,0,0,0.0,142,1303
205,22/9/2020,2471,1,2,2349,41,0,0,0,0,0.0,142,1303
206,23/9/2020,2481,0,2,2340,41,0,0,0,0,0.0,142,1303
207,24/9/2020,2492,0,2,2329,41,0,0,0,0,0.0,142,1303
208,25/9/2020,2505,0,2,2316,41,0,0,0,0,0.0,142,1303
209,26/9/2020,2516,1,1,2305,41,0,1,0,0,0.0,142,1304
210,27/9/2020,2526,0,2,2295,41,0,0,0,0,0.0,142,1304
211,28/9/2020,2537,2,2,2282,41,0,2,0,0,0.0,142,1306
212,29/9/2020,2545,2,2,2274,41,0,0,0,0,0.0,142,1306
213,30/9/2020,2554,2,1,2266,41,0,0,0,0,0.0,142,1306
214,1/10/2020,2564,3,1,2255,41,0,1,0,0,0.0,142,1307
215,2/10/2020,2577,2,2,2242,41,0,0,0,0,0.0,142,1307
216,3/10/2020,2589,3,1,2230,41,0,1,1,1,0.0,143,1308
217,4/10/2020,2601,2,2,2218,41,0,0,0,1,0.0,143,1308
218,5/10/2020,2616,2,1,2204,41,0,0,0,1,0.0,143,1308
219,6/10/2020,2626,2,1,2194,41,0,0,0,1,0.0,143,1308
220,7/10/2020,2641,2,2,2178,41,0,1,0,1,0.0,143,1309
221,8/10/2020,2658,2,2,2161,41,0,0,0,1,0.0,143,1309
222,9/10/2020,2666,1,3,2153,41,0,0,0,1,0.0,143,1309
223,10/10/2020,2677,1,3,2142,41,0,0,0,1,0.0,143,1309
224,11/10/2020,2691,0,4,2128,41,0,0,0,1,0.0,143,1309
225,12/10/2020,2702,1,3,2117,41,0,1,0,1,0.0,143,1310
226,13/10/2020,2711,3,3,2106,41,0,2,0,1,0.0,143,1312
227,14/10/2020,2723,3,3,2094,41,0,0,0,1,0.0,143,1312
228,15/10/2020,2736,4,2,2081,41,0,1,0,1,0.0,143,1313
229,16/10/2020,2749,4,1,2068,42,0,0,0,0,0.0,143,1313
230,17/10/2020,2768,4,2,2048,42,0,1,0,0,0.0,143,1314
231,18/10/2020,2785,2,3,2032,42,0,0,0,0,0.0,143,1314
232,19/10/2020,2794,2,3,2023,42,0,0,0,0,0.0,143,1314
233,20/10/2020,2805,0,5,2012,42,0,0,0,0,0.0,143,1314
234,21/10/2020,2816,0,5,2001,42,0,0,0,0,0.0,143,1314
235,22/10/2020,2835,0,5,1982,42,0,0,0,0,0.0,143,1314
236,23/10/2020,2849,1,4,1968,42,0,1,0,0,0.0,143,1315
237,24/10/2020,2864,0,5,1953,42,0,0,0,0,0.0,143,1315
238,25/10/2020,2880,0,5,1937,42,0,0,0,0,0.0,143,1315
239,26/10/2020,2893,0,3,1926,42,0,0,0,0,0.0,143,1315
240,27/10/2020,2904,0,3,1915,42,0,0,1,1,0.0,144,1315
241,28/10/2020,2917,0,3,1902,42,0,0,0,1,0.0,144,1315
242,29/10/2020,2928,0,3,1891,42,0,0,0,1,0.0,144,1315
243,30/10/2020,2942,1,3,1876,42,0,1,1,2,0.0,145,1316
244,31/10/2020,2952,1,3,1866,42,0,0,0,2,0.0,145,1316
245,1/11/2020,2969,2,3,1848,42,0,2,0,2,0.0,145,1318
246,2/11/2020,2979,2,2,1839,42,0,0,0,2,0.0,145,1318
247,3/11/2020,2990,2,2,1828,42,0,0,0,2,0.0,145,1318
248,4/11/2020,3004,1,3,1814,42,0,0,0,2,0.0,145,1318
249,5/11/2020,3019,2,3,1798,42,0,1,0,2,0.0,145,1319
250,6/11/2020,3038,1,3,1780,42,0,0,0,2,0.0,145,1319
251,7/11/2020,3066,1,2,1753,42,0,0,0,2,0.0,145,1319
252,8/11/2020,3074,0,3,1745,42,0,0,0,2,0.0,145,1319
253,9/11/2020,3082,1,3,1736,42,0,1,0,2,0.0,145,1320
254,10/11/2020,3093,1,3,1725,42,0,0,0,2,0.0,145,1320
255,11/11/2020,3109,1,1,1711,42,0,0,0,1,0.0,145,1320
256,12/11/2020,3126,1,1,1694,42,0,0,0,1,0.0,145,1320
257,13/11/2020,3143,1,1,1677,42,0,0,0,1,0.0,145,1320
258,14/11/2020,3161,2,1,1658,42,0,1,0,1,0.0,145,1321
259,15/11/2020,3176,1,2,1643,42,0,0,0,1,0.0,145,1321
260,16/11/2020,3191,0,2,1629,42,0,0,0,0,0.0,145,1321
261,17/11/2020,3203,0,2,1617,42,0,0,0,0,0.0,145,1321
262,18/11/2020,3222,0,2,1598,42,0,0,0,0,0.0,145,1321
263,19/11/2020,3239,0,2,1581,42,0,0,0,0,0.0,145,1321
264,20/11/2020,3264,1,1,1556,42,0,1,0,0,0.0,145,1322
265,21/11/2020,3276,1,1,1544,42,0,0,0,0,0.0,145,1322
266,22/11/2020,3287,1,1,1533,42,0,0,0,0,0.0,145,1322
267,23/11/2020,3301,1,1,1519,42,0,0,0,0,0.0,145,1322
268,24/11/2020,3321,1,1,1499,42,0,0,0,0,0.0,145,1322
269,25/11/2020,3337,1,1,1483,42,0,1,0,0,0.0,145,1323
270,26/11/2020,3353,1,1,1467,42,0,0,0,0,0.0,145,1323
271,27/11/2020,3368,0,1,1453,42,0,0,0,0,0.0,145,1323
272,28/11/2020,3383,0,1,1438,42,0,0,0,0,0.0,145,1323
273,29/11/2020,3399,0,1,1422,42,0,0,0,0,0.0,145,1323
274,30/11/2020,3413,0,0,1409,42,0,0,0,0,0.0,145,1323
275,1/12/2020,3423,0,0,1399,42,0,0,0,0,0.0,145,1323
276,2/12/2020,3444,0,0,1378,42,0,0,0,0,0.0,145,1323
277,3/12/2020,3455,0,0,1367,42,0,0,0,0,0.0,145,1323
278,4/12/2020,3469,1,0,1352,42,0,1,0,0,0.0,145,1324
279,5/12/2020,3485,1,0,1336,42,0,0,0,0,0.0,145,1324
280,6/12/2020,3501,1,0,1320,42,0,0,0,0,0.0,145,1324
281,7/12/2020,3516,2,0,1304,42,0,1,0,0,0.0,145,1325
282,8/12/2020,3529,2,0,1291,42,0,0,0,0,0.0,145,1325
283,9/12/2020,3548,1,1,1272,42,0,0,0,0,0.0,145,1325
284,10/12/2020,3556,0,2,1264,42,0,0,0,0,0.0,145,1325
285,11/12/2020,3568,0,0,1254,42,0,0,0,0,0.0,145,1325
286,12/12/2020,3578,0,0,1244,42,0,0,0,0,0.0,145,1325
287,13/12/2020,3590,0,0,1232,42,0,0,0,0,0.0,145,1325
288,14/12/2020,3605,0,0,1217,42,0,0,0,0,0.0,145,1325
289,15/12/2020,3621,0,0,1201,42,0,0,0,0,0.0,145,1325
290,16/12/2020,3632,0,0,1190,42,0,0,0,0,0.0,145,1325
291,17/12/2020,3650,0,0,1172,42,0,0,0,0,0.0,145,1325
292,18/12/2020,3663,0,0,1159,42,0,0,0,0,0.0,145,1325
293,19/12/2020,3686,0,0,1136,42,0,0,0,0,0.0,145,1325
294,20/12/2020,3702,1,0,1119,42,0,1,0,0,0.0,145,1326
295,21/12/2020,3716,1,0,1105,42,0,0,0,0,0.0,145,1326
296,22/12/2020,3726,1,0,1095,42,0,0,0,0,0.0,145,1326
297,23/12/2020,3484,0,1,1081,42,256,0,0,0,0.0,145,1326
298,24/12/2020,3466,0,1,1063,42,292,0,0,0,0.0,145,1326
299,25/12/2020,3437,0,1,1056,42,328,0,0,0,0.0,145,1326
300,26/12/2020,3364,0,1,1050,42,407,0,0,0,0.0,145,1326
301,27/12/2020,3276,0,1,1043,42,502,0,0,0,0.0,145,1326
302,28/12/2020,3177,0,1,1031,42,613,0,0,0,0.0,145,1326
303,29/12/2020,3089,0,1,1020,42,712,0,0,0,0.0,145,1326
304,30/12/2020,3005,0,1,1010,42,806,0,0,0,0.0,145,1326
305,31/12/2020,2928,0,1,1004,42,889,0,0,0,0.0,145,1326
306,1/1/2021,2829,0,1,993,42,999,0,0,0,0.0,145,1326
307,2/1/2021,2774,1,1,976,42,1070,1,1,1,0.0,146,1327
308,3/1/2021,2801,1,1,964,42,1055,0,0,1,0.0,146,1327
309,4/1/2021,2824,1,1,957,42,1039,0,0,1,0.0,146,1327
310,5/1/2021,2858,1,1,946,42,1016,0,0,1,0.0,146,1327
311,6/1/2021,2871,1,1,935,42,1014,0,0,1,0.0,146,1327
312,7/1/2021,2897,1,1,927,42,996,0,0,1,0.0,146,1327
313,8/1/2021,2900,0,2,917,42,1003,0,0,1,0.0,146,1327
314,9/1/2021,2914,0,1,903,42,1004,0,0,1,0.0,146,1327
315,10/1/2021,2924,0,1,896,42,1001,0,0,1,0.0,146,1327
316,11/1/2021,2933,0,1,884,42,1004,0,0,1,0.0,146,1327
317,12/1/2021,2943,0,1,870,42,1008,0,0,1,0.0,146,1327
318,13/1/2021,2949,0,1,861,42,1011,0,0,1,0.0,146,1327
319,14/1/2021,2957,0,1,845,42,1019,0,0,1,0.0,146,1327
320,15/1/2021,2962,0,0,837,42,1023,0,0,0,0.0,146,1327
321,16/1/2021,2972,0,0,821,42,1029,0,0,0,0.0,146,1327
322,17/1/2021,2979,0,0,806,42,1037,0,0,0,0.0,146,1327
323,18/1/2021,2982,0,0,788,42,1052,0,0,0,0.0,146,1327
324,19/1/2021,2988,0,0,769,42,1065,0,0,0,0.0,146,1327
325,20/1/2021,2995,0,0,755,42,1072,0,0,0,0.0,146,1327
326,21/1/2021,3004,0,0,744,42,1074,0,0,0,0.0,146,1327
327,22/1/2021,3012,0,0,727,42,1083,0,0,0,0.0,146,1327
328,23/1/2021,3015,0,0,717,42,1090,0,0,0,0.0,146,1327
329,24/1/2021,3018,0,0,710,42,1094,0,0,0,0.0,146,1327
330,25/1/2021,3022,0,0,704,42,1096,0,0,0,0.0,146,1327
331,26/1/2021,3025,1,0,694,42,1102,1,0,0,0.0,146,1328
332,27/1/2021,3032,1,0,683,42,1106,0,0,0,0.0,146,1328
333,28/1/2021,3037,1,0,673,42,1111,0,0,0,0.0,146,1328
334,29/1/2021,3040,0,1,664,42,1117,0,0,0,0.0,146,1328
335,30/1/2021,3041,0,1,658,42,1122,0,0,0,0.0,146,1328
336,31/1/2021,3045,0,1,650,42,1126,0,0,0,0.0,146,1328
337,1/2/2021,3046,0,1,643,42,1132,0,0,0,0.0,146,1328
338,2/2/2021,3053,0,1,631,42,1137,0,0,0,0.0,146,1328
339,3/2/2021,3056,0,0,629,42,1137,0,0,0,0.0,146,1328
340,4/2/2021,3061,0,0,617,42,1144,0,0,0,0.0,146,1328
341,5/2/2021,3063,0,0,611,42,1148,0,0,0,0.0,146,1328
342,6/2/2021,3067,1,0,601,42,1153,1,0,0,0.0,146,1329
343,7/2/2021,3073,1,0,589,42,1159,0,0,0,0.0,146,1329
344,8/2/2021,3079,1,0,580,42,1162,0,0,0,0.0,146,1329
345,9/2/2021,3080,0,1,572,42,1169,0,0,0,0.0,146,1329
346,10/2/2021,3084,0,1,567,42,1170,0,0,0,0.0,146,1329
347,11/2/2021,3086,0,1,555,42,1180,0,0,0,0.0,146,1329
348,12/2/2021,3088,0,1,548,42,1185,0,0,0,0.0,146,1329
349,13/2/2021,3091,0,1,540,42,1190,0,0,0,0.0,146,1329
350,14/2/2021,3094,0,1,535,42,1192,0,0,0,0.0,146,1329
351,15/2/2021,3095,0,1,531,42,1195,0,0,0,0.0,146,1329
352,16/2/2021,3100,0,1,523,42,1198,0,0,0,0.0,146,1329
353,17/2/2021,3102,0,1,517,42,1202,0,0,0,0.0,146,1329
354,18/2/2021,3110,0,1,501,42,1210,0,0,0,0.0,146,1329
355,19/2/2021,3111,0,1,496,42,1214,0,0,0,0.0,146,1329
356,20/2/2021,3113,0,1,492,42,1216,0,0,0,0.0,146,1329
357,21/2/2021,3116,1,1,485,42,1219,1,0,0,0.0,146,1330
358,22/2/2021,3119,1,1,478,42,1223,0,1,1,0.0,147,1330
359,23/2/2021,3125,1,1,470,42,1225,0,0,1,0.0,147,1330
360,24/2/2021,3129,1,1,464,42,1227,0,0,1,0.0,147,1330
361,25/2/2021,3135,0,2,454,42,1231,0,0,1,0.0,147,1330
362,26/2/2021,3141,1,2,445,42,1233,1,0,1,0.0,147,1331
363,27/2/2021,3144,1,1,440,42,1236,0,0,1,0.0,147,1331
364,28/2/2021,3150,1,1,432,42,1238,0,0,1,0.0,147,1331
365,1/3/2021,3158,0,2,422,42,1240,0,0,1,0.0,147,1331
366,2/3/2021,3164,0,2,412,42,1244,0,0,1,0.0,147,1331
367,3/3/2021,3171,0,2,402,42,1247,0,0,1,0.0,147,1331
368,4/3/2021,3176,0,2,397,42,1247,0,0,1,0.0,147,1331
369,5/3/2021,3181,0,1,392,42,1248,0,0,0,0.0,147,1331
370,6/3/2021,3185,0,1,387,42,1249,0,0,0,0.0,147,1331
371,7/3/2021,3190,0,1,379,42,1252,0,0,0,0.0,147,1331
372,8/3/2021,3194,0,1,375,42,1252,0,0,0,0.0,147,1331
373,9/3/2021,3199,0,0,370,42,1253,0,0,0,0.0,147,1331
374,10/3/2021,3202,1,0,364,42,1255,1,0,0,0.0,147,1332
375,11/3/2021,3205,1,0,360,42,1256,0,0,0,0.0,147,1332
376,12/3/2021,3206,1,0,356,42,1259,0,0,0,0.0,147,1332
377,13/3/2021,3208,1,0,353,42,1260,0,0,0,0.0,147,1332
378,14/3/2021,3211,1,0,346,42,1264,0,0,0,0.0,147,1332
379,15/3/2021,3215,1,0,341,42,1265,0,0,0,0.0,147,1332
380,16/3/2021,3219,0,1,333,42,1269,0,0,0,0.0,147,1332
381,17/3/2021,3222,0,0,328,42,1272,0,0,0,0.0,147,1332
382,18/3/2021,3226,0,0,324,42,1272,0,0,0,0.0,147,1332
383,19/3/2021,3230,0,0,319,42,1273,0,0,0,0.0,147,1332
384,20/3/2021,3232,0,0,312,42,1278,0,0,0,0.0,147,1332
385,21/3/2021,3234,0,0,306,42,1282,0,0,0,0.0,147,1332
386,22/3/2021,3237,0,0,303,42,1282,0,0,0,0.0,147,1332
387,23/3/2021,3240,0,0,300,42,1282,0,0,0,0.0,147,1332
388,24/3/2021,3244,0,0,296,42,1282,0,0,0,0.0,147,1332
389,25/3/2021,3246,0,0,288,42,1288,0,0,0,0.0,147,1332
390,26/3/2021,3248,0,0,286,42,1288,0,0,0,0.0,147,1332
391,27/3/2021,3250,0,0,282,42,1290,0,0,0,0.0,147,1332
392,28/3/2021,3254,0,0,276,42,1292,0,0,0,0.0,147,1332
393,29/3/2021,3256,0,0,274,42,1292,0,0,0,0.0,147,1332
394,30/3/2021,3261,0,0,268,42,1293,0,0,0,0.0,147,1332
395,31/3/2021,3266,0,0,261,42,1295,0,0,0,0.0,147,1332
396,1/4/2021,3269,0,0,254,42,1299,0,0,0,0.0,147,1332
397,2/4/2021,3270,0,0,251,42,1301,0,0,0,0.0,147,1332
398,3/4/2021,3274,0,0,243,42,1305,0,0,0,0.0,147,1332
399,4/4/2021,3276,0,0,240,42,1306,0,0,0,0.0,147,1332
400,5/4/2021,3278,1,0,237,42,1306,1,0,0,0.0,147,1333
401,6/4/2021,3281,2,0,231,42,1308,1,0,0,0.0,147,1334
402,7/4/2021,3286,3,0,225,42,1308,1,0,0,0.0,147,1335
403,8/4/2021,3291,3,1,219,42,1308,1,0,0,0.0,147,1336
404,9/4/2021,3296,4,1,212,42,1309,1,0,0,0.0,147,1337
405,10/4/2021,3298,5,1,208,42,1310,1,0,0,0.0,147,1338
406,11/4/2021,3301,4,2,205,42,1310,0,0,0,0.0,147,1338
407,12/4/2021,3302,2,4,203,42,1311,0,0,0,0.0,147,1338
408,13/4/2021,3303,2,4,200,42,1313,0,0,0,0.0,147,1338
409,14/4/2021,3302,4,3,198,42,1315,2,0,0,0.0,147,1340
410,15/4/2021,3304,3,3,197,42,1315,0,0,0,0.0,147,1340
411,16/4/2021,3306,3,4,193,42,1316,1,0,0,0.0,147,1341
412,17/4/2021,3308,2,4,192,42,1316,1,0,0,0.0,147,1342
413,18/4/2021,3310,2,2,190,42,1318,0,0,0,0.0,147,1342
414,19/4/2021,3312,1,2,187,42,1320,0,0,0,0.0,147,1342
415,20/4/2021,3313,1,2,185,42,1321,0,0,0,0.0,147,1342
416,21/4/2021,3317,1,1,179,42,1324,0,0,0,0.0,147,1342
417,22/4/2021,3319,1,1,176,42,1325,0,0,0,0.0,147,1342
418,23/4/2021,3323,2,0,172,42,1325,1,0,0,0.0,147,1343
419,24/4/2021,3325,1,2,168,42,1326,1,0,0,0.0,147,1344
420,25/4/2021,3326,1,2,167,42,1326,0,0,0,0.0,147,1344
421,26/4/2021,3325,2,2,166,42,1327,1,0,0,0.0,147,1345
422,27/4/2021,3327,3,2,160,42,1330,1,0,0,0.0,147,1346
423,28/4/2021,3329,3,2,157,42,1331,0,0,0,0.0,147,1346
424,29/4/2021,3329,2,3,157,42,1331,0,0,0,0.0,147,1346
425,30/4/2021,3333,2,3,153,42,1331,0,1,1,0.0,148,1346
426,1/5/2021,3335,1,4,148,42,1334,0,0,1,0.0,148,1346
427,2/5/2021,3338,1,4,145,42,1334,0,0,1,0.0,148,1346
428,3/5/2021,3340,1,4,143,42,1334,0,0,1,0.0,148,1346
429,4/5/2021,3340,2,4,142,42,1334,2,0,1,0.0,148,1348
430,5/5/2021,3342,2,4,140,42,1334,0,0,1,0.0,148,1348
431,6/5/2021,3345,3,3,140,42,1331,1,0,1,0.0,148,1349
432,7/5/2021,3345,1,4,139,42,1333,0,0,1,0.0,148,1349
433,8/5/2021,3347,2,4,136,42,1333,1,0,1,0.0,148,1350
434,9/5/2021,3349,1,4,133,42,1335,0,0,1,0.0,148,1350
435,10/5/2021,3349,1,3,133,42,1336,0,0,0,0.0,148,1350
436,11/5/2021,3350,1,2,133,42,1336,0,0,0,0.0,148,1350
437,12/5/2021,3351,0,3,132,42,1336,0,0,0,0.0,148,1350
438,13/5/2021,3351,0,2,133,42,1336,0,0,0,0.0,148,1350
439,14/5/2021,3353,0,2,129,42,1338,0,0,0,0.0,148,1350
440,15/5/2021,3357,0,2,127,42,1336,0,0,0,0.0,148,1350
441,16/5/2021,3359,0,1,127,42,1335,0,0,0,0.0,148,1350
442,17/5/2021,3359,0,1,127,42,1335,0,0,0,0.0,148,1350
443,18/5/2021,3360,0,1,125,42,1336,0,0,0,0.0,148,1350
444,19/5/2021,3360,1,1,123,42,1337,1,0,0,0.0,148,1351
445,20/5/2021,3362,1,1,120,42,1338,0,0,0,0.0,148,1351
446,21/5/2021,3362,2,1,120,42,1337,2,0,0,0.0,148,1353
447,22/5/2021,3363,2,1,119,42,1337,0,0,0,0.0,148,1353
448,23/5/2021,3365,2,1,118,42,1336,0,0,0,0.0,148,1353
449,24/5/2021,3365,2,1,115,42,1339,0,0,0,0.0,148,1353
450,25/5/2021,3365,2,0,116,42,1339,0,0,0,0.0,148,1353
451,26/5/2021,3368,1,1,112,42,1340,0,0,0,0.0,148,1353
452,27/5/2021,3369,2,0,112,42,1339,1,0,0,0.0,148,1354
453,28/5/2021,3369,1,1,111,42,1340,0,0,0,0.0,148,1354
454,29/5/2021,3368,2,0,112,42,1340,1,0,0,0.0,148,1355
455,30/5/2021,3369,1,1,112,42,1339,0,0,0,0.0,148,1355
456,31/5/2021,3371,0,2,110,42,1339,0,0,0,0.0,148,1355
457,1/6/2021,3372,0,2,109,42,1339,0,0,0,0.0,148,1355
458,2/6/2021,3374,0,2,108,42,1338,0,0,0,0.0,148,1355
459,3/6/2021,3374,0,2,107,42,1339,0,0,0,0.0,148,1355
460,4/6/2021,3376,0,2,106,42,1338,0,0,0,0.0,148,1355
461,5/6/2021,3378,1,2,105,42,1336,1,0,0,0.0,148,1356
462,6/6/2021,3378,1,2,104,42,1337,1,0,0,0.0,148,1357
463,7/6/2021,3382,1,1,102,42,1336,0,0,0,0.0,148,1357
464,8/6/2021,3384,1,1,101,42,1335,0,0,0,0.0,148,1357
465,9/6/2021,3386,1,1,100,42,1334,0,0,0,0.0,148,1357
466,10/6/2021,3387,2,1,99,42,1333,1,0,0,0.0,148,1358
467,11/6/2021,3389,2,1,98,42,1332,0,0,0,0.0,148,1358
468,12/6/2021,3391,1,2,97,42,1331,0,0,0,0.0,148,1358
469,13/6/2021,3392,1,3,96,42,1330,1,0,0,0.0,148,1359
470,14/6/2021,3393,1,2,96,42,1330,0,0,0,0.0,148,1359
471,15/6/2021,3396,1,2,95,42,1328,0,0,0,0.0,148,1359
472,16/6/2021,3400,1,1,95,42,1325,0,0,0,0.0,148,1359
473,17/6/2021,3401,1,1,94,42,1325,0,0,0,0.0,148,1359
474,18/6/2021,3405,0,1,92,42,1324,0,0,0,0.0,148,1359
475,19/6/2021,3407,0,0,90,42,1325,0,0,0,0.0,148,1359
476,20/6/2021,3408,0,0,90,42,1324,0,0,0,0.0,148,1359
477,21/6/2021,3411,0,0,88,42,1323,0,0,0,0.0,148,1359
478,22/6/2021,3414,1,0,87,42,1320,1,0,0,0.0,148,1360
479,23/6/2021,3416,1,0,86,42,1319,0,0,0,0.0,148,1360
480,24/6/2021,3417,1,0,86,42,1318,0,0,0,0.0,148,1360
481,25/6/2021,3417,0,1,86,42,1318,0,0,0,0.0,148,1360
482,26/6/2021,3417,1,1,85,42,1318,1,0,0,0.0,148,1361
483,27/6/2021,3423,2,1,85,42,1311,1,0,0,0.0,148,1362
484,28/6/2021,3425,4,0,86,42,1307,2,0,0,0.0,148,1364
485,29/6/2021,3428,4,0,85,42,1305,0,0,0,0.0,148,1364
486,30/6/2021,3431,4,1,84,42,1302,1,0,0,0.0,148,1365
487,1/7/2021,3432,2,3,83,42,1302,0,0,0,0.0,148,1365
488,2/7/2021,3432,2,4,83,42,1301,1,0,0,0.0,148,1366
489,3/7/2021,3435,2,3,83,42,1299,0,0,0,0.0,148,1366
490,4/7/2021,3436,3,2,83,42,1298,1,0,0,0.0,148,1367
491,5/7/2021,3439,2,2,83,42,1296,0,0,0,0.0,148,1367
492,6/7/2021,3439,3,2,83,42,1295,1,0,0,0.0,148,1368
493,7/7/2021,3444,1,3,82,42,1292,0,0,0,0.0,148,1368
494,8/7/2021,3447,2,2,82,42,1289,1,0,0,0.0,148,1369
495,9/7/2021,3449,3,3,82,42,1285,2,0,0,0.0,148,1371
496,10/7/2021,3451,4,2,80,42,1285,1,0,0,0.0,148,1372
497,11/7/2021,3453,3,4,80,42,1282,1,0,0,0.0,148,1373
498,12/7/2021,3457,3,2,79,42,1281,0,0,0,0.0,148,1373
499,13/7/2021,3459,3,2,79,42,1279,0,0,0,0.0,148,1373
500,14/7/2021,3465,1,3,78,42,1275,0,0,0,0.0,148,1373
501,15/7/2021,3471,2,3,77,42,1269,1,0,0,0.0,148,1374
502,16/7/2021,3475,1,4,77,42,1265,0,0,0,0.0,148,1374
503,17/7/2021,3479,2,4,76,42,1261,1,0,0,0.0,148,1375
504,18/7/2021,3481,2,4,76,42,1259,1,0,0,0.0,148,1376
505,19/7/2021,3482,3,4,76,42,1257,1,0,0,0.0,148,1377
506,20/7/2021,3486,5,4,74,42,1253,2,0,0,0.0,148,1379
507,21/7/2021,3490,4,4,75,42,1249,0,0,0,0.0,148,1379
508,22/7/2021,3494,4,3,75,42,1246,0,0,0,0.0,148,1379
509,23/7/2021,3498,4,4,75,42,1241,1,0,0,0.0,148,1380
510,24/7/2021,3502,2,5,76,42,1237,0,0,0,0.0,148,1380
511,25/7/2021,3505,2,4,77,42,1234,0,0,0,0.0,148,1380
512,26/7/2021,3507,2,3,78,42,1232,0,0,0,0.0,148,1380
513,27/7/2021,3513,2,2,77,42,1228,0,0,0,0.0,148,1380
514,28/7/2021,3518,1,4,76,42,1223,1,0,0,0.0,148,1381
515,29/7/2021,3518,1,4,76,42,1223,0,0,0,0.0,148,1381
516,30/7/2021,3522,1,4,75,42,1220,0,0,0,0.0,148,1381
517,31/7/2021,3527,2,2,76,42,1215,1,0,0,0.0,148,1382
518,1/8/2021,3531,2,0,78,42,1211,0,0,0,0.0,148,1382
519,2/8/2021,3533,1,1,78,42,1209,0,0,0,0.0,148,1382
520,3/8/2021,3537,0,2,78,42,1205,0,0,0,0.0,148,1382
521,4/8/2021,3539,0,2,78,42,1203,0,0,0,0.0,148,1382
522,5/8/2021,3543,0,2,78,42,1199,0,0,0,0.0,148,1382
523,6/8/2021,3544,1,1,79,42,1197,1,0,0,0.0,148,1383
524,7/8/2021,3547,2,1,79,42,1193,1,0,0,0.0,148,1384
525,8/8/2021,3549,1,1,80,42,1191,0,0,0,0.0,148,1384
526,9/8/2021,3555,1,1,80,42,1185,0,0,0,0.0,148,1384
527,10/8/2021,3561,1,1,79,42,1180,0,0,0,0.0,148,1384
528,11/8/2021,3568,1,1,79,42,1173,0,0,0,0.0,148,1384
529,12/8/2021,3570,0,2,79,42,1171,0,0,0,0.0,148,1384
530,13/8/2021,3574,1,2,79,42,1166,1,0,0,0.0,148,1385
531,14/8/2021,3582,1,2,79,42,1158,0,0,0,0.0,148,1385
532,15/8/2021,3585,2,2,78,42,1155,1,0,0,0.0,148,1386
533,16/8/2021,3590,2,1,78,42,1151,0,0,0,0.0,148,1386
534,17/8/2021,3591,4,0,79,42,1148,2,0,0,0.0,148,1388
535,18/8/2021,3595,3,1,79,42,1144,0,0,0,0.0,148,1388
536,19/8/2021,3598,4,1,78,42,1141,1,0,0,0.0,148,1389
537,20/8/2021,3604,7,1,77,42,1133,3,0,0,0.0,148,1392
538,21/8/2021,3605,7,1,77,42,1132,0,0,0,0.0,148,1392
539,22/8/2021,3607,6,3,77,42,1129,1,0,0,0.0,148,1393
540,23/8/2021,3610,6,4,78,42,1124,2,0,0,0.0,148,1395
541,24/8/2021,3616,4,5,79,42,1118,0,0,0,0.0,148,1395
542,25/8/2021,3618,5,6,79,42,1114,2,0,0,0.0,148,1397
543,26/8/2021,3623,2,7,80,42,1110,0,0,0,0.0,148,1397
544,27/8/2021,3629,2,5,80,42,1106,0,0,0,0.0,148,1397
545,28/8/2021,3636,2,5,80,42,1099,0,0,0,0.0,148,1397
546,29/8/2021,3642,2,5,80,42,1093,0,0,0,0.0,148,1397
547,30/8/2021,3645,3,4,80,42,1090,1,0,0,0.0,148,1398
548,31/8/2021,3651,1,5,81,42,1084,0,0,0,0.0,148,1398
549,1/9/2021,3651,2,6,80,42,1083,2,0,0,0.0,148,1400
550,2/9/2021,3655,3,5,81,42,1078,1,0,0,0.0,148,1401
551,3/9/2021,3661,3,5,80,42,1073,0,0,0,0.0,148,1401
552,4/9/2021,3662,4,6,80,42,1070,2,0,0,0.0,148,1403
553,5/9/2021,3662,4,6,82,42,1068,2,0,0,0.0,148,1405
554,6/9/2021,3664,6,6,82,42,1064,2,0,0,0.0,148,1407
555,7/9/2021,3667,4,6,83,42,1062,0,0,0,0.0,148,1407
556,8/9/2021,3667,4,6,84,42,1061,1,0,0,0.0,148,1408
557,9/9/2021,3673,3,6,85,42,1055,0,0,0,0.0,148,1408
558,10/9/2021,3675,6,5,85,42,1051,3,0,0,0.0,148,1411
559,11/9/2021,3680,5,5,84,42,1048,0,0,0,0.0,148,1411
560,12/9/2021,3686,4,4,85,42,1043,0,0,0,0.0,148,1411
561,13/9/2021,3688,5,3,86,42,1040,1,0,0,0.0,148,1412
562,14/9/2021,3692,5,4,87,42,1034,2,0,0,0.0,148,1414
563,15/9/2021,3699,5,3,87,42,1028,0,0,0,0.0,148,1414
564,16/9/2021,3701,4,3,88,42,1026,0,0,0,0.0,148,1414
565,17/9/2021,3702,3,2,91,42,1024,1,0,0,0.0,148,1415
566,18/9/2021,3707,3,1,92,42,1019,0,0,0,0.0,148,1415
567,19/9/2021,3711,3,2,92,42,1014,1,0,0,0.0,148,1416
568,20/9/2021,3715,2,2,92,42,1011,0,0,0,0.0,148,1416
569,21/9/2021,3717,1,3,92,42,1009,0,0,0,0.0,148,1416
570,22/9/2021,3717,1,4,92,42,1008,1,0,0,0.0,148,1417
571,23/9/2021,3723,2,2,94,42,1001,1,0,0,0.0,148,1418
572,24/9/2021,3729,2,1,94,42,996,0,0,0,0.0,148,1418
573,25/9/2021,3737,2,1,94,42,988,0,0,0,0.0,148,1418
574,26/9/2021,3738,1,2,93,42,988,0,0,0,0.0,148,1418
575,27/9/2021,3742,3,2,93,42,982,2,0,0,0.0,148,1420
576,28/9/2021,3744,3,2,93,42,980,0,0,0,0.0,148,1420
577,29/9/2021,3746,3,3,94,42,976,2,0,0,0.0,148,1422
578,30/9/2021,3750,3,3,94,42,972,0,0,0,0.0,148,1422
579,1/10/2021,3757,3,2,95,42,965,0,0,0,0.0,148,1422
580,2/10/2021,3759,2,3,95,42,963,0,0,0,0.0,148,1422
581,3/10/2021,3761,1,3,96,42,961,0,0,0,0.0,148,1422
582,4/10/2021,3767,2,3,96,42,954,1,0,0,0.0,148,1423
583,5/10/2021,3772,2,4,96,42,948,1,0,0,0.0,148,1424
584,6/10/2021,3778,2,4,96,42,942,0,0,0,0.0,148,1424
585,7/10/2021,3781,3,3,97,42,938,1,0,0,0.0,148,1425
586,8/10/2021,3783,3,2,98,42,936,0,0,0,0.0,148,1425
587,9/10/2021,3786,5,2,99,42,930,3,0,0,0.0,148,1428
588,10/10/2021,3786,5,2,100,42,929,1,0,0,0.0,148,1429
589,11/10/2021,3788,2,5,100,42,927,0,0,0,0.0,148,1429
590,12/10/2021,3787,3,5,100,42,927,1,0,0,0.0,148,1430
591,13/10/2021,3787,3,5,101,42,926,1,0,0,0.0,148,1431
592,14/10/2021,3789,3,5,102,42,923,1,0,0,0.0,148,1432
593,15/10/2021,3792,2,4,104,42,920,0,0,0,0.0,148,1432
594,16/10/2021,3794,2,3,105,42,918,0,0,0,0.0,148,1432
595,17/10/2021,3798,2,3,105,42,914,0,0,0,0.0,148,1432
596,18/10/2021,3801,1,4,104,42,912,0,0,0,0.0,148,1432
597,19/10/2021,3802,3,3,105,42,909,2,0,0,0.0,148,1434
598,20/10/2021,3804,3,3,106,42,906,1,0,0,0.0,148,1435
599,21/10/2021,3806,4,2,107,42,903,1,0,0,0.0,148,1436
600,22/10/2021,3808,5,2,107,42,900,1,0,0,0.0,148,1437
601,23/10/2021,3809,7,1,108,42,897,2,0,0,0.0,148,1439
602,24/10/2021,3812,5,2,109,42,894,0,0,0,0.0,148,1439
603,25/10/2021,3813,5,4,109,42,891,2,0,0,0.0,148,1441
604,26/10/2021,3815,4,6,108,42,889,1,0,0,0.0,148,1442
605,27/10/2021,3817,4,6,109,42,886,1,0,0,0.0,148,1443
606,28/10/2021,3820,5,6,109,42,882,1,0,0,0.0,148,1444
607,29/10/2021,3819,5,7,109,42,882,2,0,0,0.0,148,1446
608,30/10/2021,3821,6,7,107,42,881,1,0,0,0.0,148,1447
609,31/10/2021,3823,5,7,108,42,879,0,0,0,0.0,148,1447
610,1/11/2021,3824,5,5,109,42,879,0,1,1,0.0,149,1447
611,2/11/2021,3827,5,5,109,42,876,0,0,1,0.0,149,1447
612,3/11/2021,3826,5,7,109,42,875,2,0,1,0.0,149,1449
613,4/11/2021,3827,4,7,111,42,873,1,0,1,0.0,149,1450
614,5/11/2021,3831,4,4,115,42,868,1,0,1,0.0,149,1451
615,6/11/2021,3833,3,4,116,42,866,0,0,1,0.0,149,1451
616,7/11/2021,3834,3,4,116,42,865,0,0,1,0.0,149,1451
617,8/11/2021,3836,2,5,116,42,863,0,0,1,0.0,149,1451
618,9/11/2021,3836,3,4,116,42,863,1,0,1,0.0,149,1452
619,10/11/2021,3836,5,5,116,42,860,3,0,1,0.0,149,1455
620,11/11/2021,3834,6,6,116,42,860,2,0,1,0.0,149,1457
621,12/11/2021,3836,6,3,119,42,858,0,0,0,0.0,149,1457
622,13/11/2021,3837,9,4,118,42,854,4,0,0,0.0,149,1461
623,14/11/2021,3837,9,6,117,42,853,2,0,0,0.0,149,1463
624,15/11/2021,3837,7,7,118,42,853,1,0,0,0.0,149,1464
625,16/11/2021,3836,9,7,120,42,850,4,0,0,0.0,149,1468
626,17/11/2021,3837,8,10,120,42,847,2,0,0,0.0,149,1470
627,18/11/2021,3834,14,9,120,42,845,6,0,0,0.0,149,1476
628,19/11/2021,3836,8,15,120,42,843,0,0,0,0.0,149,1476
629,20/11/2021,3834,9,17,121,42,841,4,0,0,0.0,149,1480
630,21/11/2021,3832,10,15,125,42,840,3,0,0,0.0,149,1483
631,22/11/2021,3832,10,13,128,42,839,1,0,0,0.0,149,1484
632,23/11/2021,3831,7,15,131,42,838,2,0,0,0.0,149,1486
633,24/11/2021,3834,7,14,133,42,834,1,0,0,0.0,149,1487
634,25/11/2021,3836,10,14,134,42,828,4,0,0,0.0,149,1491
635,26/11/2021,3834,11,14,135,42,828,3,0,0,0.0,149,1494
636,27/11/2021,3834,8,16,137,42,827,1,0,0,0.0,149,1495
637,28/11/2021,3833,11,14,140,42,824,4,0,0,0.0,149,1499
638,29/11/2021,3830,13,15,142,42,822,5,0,0,0.0,149,1504
639,30/11/2021,3830,16,14,145,42,817,5,0,0,0.0,149,1509
640,1/12/2021,3828,15,16,146,42,817,2,0,0,0.0,149,1511
641,2/12/2021,3831,16,14,148,42,813,2,0,0,0.0,149,1513
642,3/12/2021,3831,15,13,152,42,811,2,0,0,0.0,149,1515
643,4/12/2021,3832,11,17,152,42,810,1,0,0,0.0,149,1516
644,5/12/2021,3829,11,15,158,42,809,4,0,0,0.0,149,1520
645,6/12/2021,3834,10,15,159,42,804,1,0,0,0.0,149,1521
646,7/12/2021,3834,12,12,162,42,802,3,0,0,0.0,149,1524
647,8/12/2021,3833,12,13,164,42,800,3,0,0,0.0,149,1527
648,9/12/2021,3832,12,13,165,42,800,2,0,0,0.0,149,1529
649,10/12/2021,3833,10,13,169,42,797,2,1,1,0.0,150,1531
650,11/12/2021,3831,12,10,174,42,795,4,0,1,0.0,150,1535
651,12/12/2021,3831,10,12,175,42,794,1,0,1,0.0,150,1536
652,13/12/2021,3832,9,13,177,42,791,2,0,1,0.0,150,1538
653,14/12/2021,3830,9,15,177,42,791,3,0,1,0.0,150,1541
654,15/12/2021,3827,10,12,182,42,791,3,0,0,0.0,150,1544
655,16/12/2021,3825,10,13,185,42,789,4,0,0,0.0,150,1548
656,17/12/2021,3824,12,14,187,42,785,5,0,0,0.0,150,1553
657,18/12/2021,3826,12,14,190,42,780,3,0,0,0.0,150,1556
658,19/12/2021,3822,15,17,190,42,778,6,0,0,0.0,150,1562
659,20/12/2021,3817,18,19,191,42,777,7,0,0,0.0,150,1569
660,21/12/2021,3814,19,19,194,42,776,4,0,0,0.0,150,1573
661,22/12/2021,3812,18,18,199,42,775,3,0,0,0.0,150,1576
662,23/12/2021,3806,23,18,201,42,774,8,0,0,0.0,150,1584
663,24/12/2021,3802,20,21,206,42,773,5,0,0,0.0,150,1589
664,25/12/2021,3802,19,22,208,42,771,3,0,0,0.0,150,1592
665,26/12/2021,3802,17,19,214,42,770,1,0,0,0.0,150,1593
666,27/12/2021,3798,19,22,217,42,766,8,0,0,0.0,150,1601
667,28/12/2021,3794,22,20,222,42,764,6,0,0,0.0,150,1607
668,29/12/2021,3791,18,26,225,42,762,5,0,0,0.0,150,1612
669,30/12/2021,3786,21,25,230,42,760,7,0,0,0.0,150,1619
670,31/12/2021,3783,20,27,234,42,758,5,0,0,0.0,150,1624
671,1/1/2022,3777,23,28,237,42,757,7,0,0,0.0,150,1631
672,2/1/2022,3772,23,27,245,42,755,7,0,0,0.0,150,1638
673,3/1/2022,3765,25,28,251,42,753,9,0,0,0.0,150,1647
674,4/1/2022,3760,27,24,259,42,752,6,0,0,0.0,150,1653
675,5/1/2022,3760,23,30,262,42,747,5,0,0,0.0,150,1658
676,6/1/2022,3755,28,26,269,42,744,8,0,0,0.0,150,1666
677,7/1/2022,3748,27,33,271,42,743,8,0,0,0.0,150,1674
678,8/1/2022,3739,30,35,275,42,743,10,0,0,0.0,150,1684
679,9/1/2022,3735,26,36,281,42,744,4,0,0,0.0,150,1688
680,10/1/2022,3731,27,35,287,42,742,6,0,0,0.0,150,1694
681,11/1/2022,3727,28,32,293,42,742,5,0,0,0.0,150,1699
682,12/1/2022,3729,23,35,297,42,738,2,0,0,0.0,150,1701
683,13/1/2022,3729,19,35,305,42,734,4,0,0,0.0,150,1705
684,14/1/2022,3724,23,34,310,42,731,8,0,0,0.0,150,1713
685,15/1/2022,3716,23,33,319,42,731,8,0,0,0.0,150,1721
686,16/1/2022,3718,16,34,326,42,728,1,0,0,0.0,150,1722
687,17/1/2022,3715,19,28,332,42,728,5,0,0,0.0,150,1727
688,18/1/2022,3713,21,27,337,42,724,6,0,0,0.0,150,1733
689,19/1/2022,3711,17,27,343,42,724,2,0,0,0.0,150,1735
690,20/1/2022,3711,13,27,347,42,724,1,0,0,0.0,150,1736
691,21/1/2022,3708,13,27,351,42,723,4,0,0,0.0,150,1740
692,22/1/2022,3707,14,24,357,42,720,4,0,0,0.0,150,1744
693,23/1/2022,3707,14,20,364,42,717,3,0,0,0.0,150,1747
694,24/1/2022,3704,16,18,369,42,715,5,0,0,0.0,150,1752
695,25/1/2022,3698,20,16,372,42,716,5,0,0,0.0,150,1757
696,26/1/2022,3697,14,21,375,42,715,2,0,0,0.0,150,1759
697,27/1/2022,3692,17,24,375,42,714,7,0,0,0.0,150,1766
698,28/1/2022,3691,16,24,378,42,713,2,0,0,0.0,150,1768
699,29/1/2022,3690,15,21,384,42,712,2,0,0,0.0,150,1770
700,30/1/2022,3685,21,15,391,42,710,7,0,0,0.0,150,1777
701,31/1/2022,3683,19,16,394,42,710,2,0,0,0.0,150,1779
702,1/2/2022,3682,17,17,396,42,710,3,0,0,0.0,150,1782
703,2/2/2022,3683,16,19,395,42,709,2,0,0,0.0,150,1784
704,3/2/2022,3683,17,20,395,42,707,4,0,0,0.0,150,1788
705,4/2/2022,3683,17,16,402,42,704,3,0,0,0.0,150,1791
706,5/2/2022,3687,12,17,406,42,700,1,0,0,0.0,150,1792
707,6/2/2022,3685,11,16,411,42,699,4,0,0,0.0,150,1796
708,7/2/2022,3682,15,16,411,42,698,5,0,0,0.0,150,1801
709,8/2/2022,3681,16,15,413,42,697,2,0,0,0.0,150,1803
710,9/2/2022,3682,13,21,413,42,693,3,0,0,0.0,150,1806
711,10/2/2022,3681,19,20,413,42,689,7,0,0,0.0,150,1813
712,11/2/2022,3679,15,21,418,42,689,2,0,0,0.0,150,1815
713,12/2/2022,3674,16,21,423,42,688,6,0,0,0.0,150,1821
714,13/2/2022,3672,17,23,425,42,685,5,0,0,0.0,150,1826
715,14/2/2022,3670,19,20,431,42,682,5,0,0,0.0,150,1831
716,15/2/2022,3665,21,17,437,42,682,6,0,0,0.0,150,1837
717,16/2/2022,3666,17,17,442,42,680,1,0,0,0.0,150,1838
718,17/2/2022,3662,14,21,445,42,680,4,0,0,0.0,150,1842
719,18/2/2022,3660,16,21,446,42,679,4,0,0,0.0,150,1846
720,19/2/2022,3654,21,22,448,42,677,8,0,0,0.0,150,1854
721,20/2/2022,3651,20,21,453,42,677,3,0,0,0.0,150,1857
722,21/2/2022,3651,15,25,456,42,675,2,0,0,0.0,150,1859
723,22/2/2022,3650,12,24,461,42,675,1,0,0,0.0,150,1860
724,23/2/2022,3650,11,25,463,42,673,2,0,0,0.0,150,1862
725,24/2/2022,3648,12,22,467,42,673,2,0,0,0.0,150,1864
726,25/2/2022,3646,10,25,470,42,671,4,0,0,0.0,150,1868
727,26/2/2022,3643,11,16,482,42,670,4,0,0,0.0,150,1872
728,27/2/2022,3641,12,15,484,42,670,2,0,0,0.0,150,1874
729,28/2/2022,3641,11,14,488,42,668,2,0,0,0.0,150,1876
730,1/3/2022,3637,12,15,490,42,668,4,0,0,0.0,150,1880
731,2/3/2022,3638,11,15,492,42,666,1,0,0,0.0,150,1881
732,3/3/2022,3639,7,19,493,42,664,1,0,0,0.0,150,1882
733,4/3/2022,3639,7,18,494,42,664,2,0,0,0.0,150,1884
734,5/3/2022,3634,11,17,497,42,663,6,0,0,0.0,150,1890
735,6/3/2022,3632,14,12,502,42,662,3,0,0,0.0,150,1893
736,7/3/2022,3631,15,11,504,42,661,2,0,0,0.0,150,1895
737,8/3/2022,3631,13,10,507,42,661,1,0,0,0.0,150,1896
738,9/3/2022,3629,11,12,509,42,661,2,0,0,0.0,150,1898
739,10/3/2022,3629,11,12,511,42,659,2,0,0,0.0,150,1900
740,11/3/2022,3628,9,15,511,42,659,2,0,0,0.0,150,1902
741,12/3/2022,3628,10,13,515,42,656,3,0,0,0.0,150,1905
742,13/3/2022,3624,11,12,519,42,656,5,0,0,0.0,150,1910
743,14/3/2022,3627,11,13,519,42,652,2,0,0,0.0,150,1912
744,15/3/2022,3626,14,12,521,42,649,5,0,0,0.0,150,1917
745,16/3/2022,3629,12,12,524,42,645,1,0,0,0.0,150,1918
746,17/3/2022,3628,14,13,524,42,643,3,0,0,0.0,150,1921
747,18/3/2022,3624,14,16,525,42,643,4,0,0,0.0,150,1925
748,19/3/2022,3623,12,18,527,42,642,2,0,0,0.0,150,1927
749,20/3/2022,3621,10,21,530,42,640,4,0,0,0.0,150,1931
750,21/3/2022,3617,11,20,534,42,640,4,0,0,0.0,150,1935
751,22/3/2022,3615,10,20,537,42,640,2,0,0,0.0,150,1937
752,23/3/2022,3613,10,20,539,42,640,2,0,0,0.0,150,1939
753,24/3/2022,3615,7,20,543,42,637,1,0,0,0.0,150,1940
754,25/3/2022,3609,11,15,550,42,637,6,0,0,0.0,150,1946
755,26/3/2022,3611,12,15,549,42,635,3,0,0,0.0,150,1949
756,27/3/2022,3610,12,15,552,42,633,3,0,0,0.0,150,1952
757,28/3/2022,3606,17,12,555,42,632,5,0,0,0.0,150,1957
758,29/3/2022,3607,15,11,558,42,631,0,0,0,0.0,150,1957
759,30/3/2022,3608,10,16,558,42,630,0,0,0,0.0,150,1957
760,31/3/2022,3605,10,18,560,42,629,4,0,0,0.0,150,1961
761,1/4/2022,3606,10,19,562,42,625,3,0,0,0.0,150,1964
762,2/4/2022,3608,7,18,566,42,623,0,0,0,0.0,150,1964
763,3/4/2022,3611,6,15,571,42,619,1,0,0,0.0,150,1965
764,4/4/2022,3610,5,13,575,42,619,1,0,0,0.0,150,1966
765,5/4/2022,3608,6,12,577,42,619,2,0,0,0.0,150,1968
766,6/4/2022,3610,5,12,578,42,617,0,0,0,0.0,150,1968
767,7/4/2022,3608,7,8,583,42,616,3,0,0,0.0,150,1971
768,8/4/2022,3610,7,8,583,42,614,1,0,0,0.0,150,1972
769,9/4/2022,3607,9,7,585,42,614,3,0,0,0.0,150,1975
770,10/4/2022,3609,8,4,588,42,613,0,0,0,0.0,150,1975
771,11/4/2022,3611,5,7,588,42,611,1,0,0,0.0,150,1976
772,12/4/2022,3613,4,8,589,42,608,1,0,0,0.0,150,1977
773,13/4/2022,3617,5,4,593,42,603,1,0,0,0.0,150,1978
774,14/4/2022,3619,3,4,595,42,601,0,0,0,0.0,150,1978
775,15/4/2022,3621,2,4,594,42,601,0,0,0,0.0,150,1978
776,16/4/2022,3620,1,6,594,42,601,1,0,0,0.0,150,1979
777,17/4/2022,3625,1,4,594,42,598,0,0,0,0.0,150,1979
778,18/4/2022,3626,1,4,594,42,597,0,0,0,0.0,150,1979
779,19/4/2022,3628,1,4,593,42,596,0,0,0,0.0,150,1979
780,20/4/2022,3631,1,4,593,42,593,0,0,0,0.0,150,1979
781,21/4/2022,3632,1,2,595,42,592,0,0,0,0.0,150,1979
782,22/4/2022,3633,0,3,595,42,591,0,0,0,0.0,150,1979
783,23/4/2022,3632,1,2,596,42,591,1,0,0,0.0,150,1980
784,24/4/2022,3635,1,1,597,42,588,0,0,0,0.0,150,1980
785,25/4/2022,3640,1,1,597,42,583,0,0,0,0.0,150,1980
786,26/4/2022,3641,2,0,597,42,582,1,0,0,0.0,150,1981
787,27/4/2022,3646,1,1,595,42,579,0,0,0,0.0,150,1981
788,28/4/2022,3647,0,2,595,42,578,0,0,0,0.0,150,1981
789,29/4/2022,3649,1,2,594,42,576,1,0,0,0.0,150,1982
790,30/4/2022,3648,3,2,593,42,576,2,0,0,0.0,150,1984
791,1/5/2022,3652,2,3,592,42,573,0,0,0,0.0,150,1984
792,2/5/2022,3655,2,2,593,42,570,0,0,0,0.0,150,1984
793,3/5/2022,3655,3,2,593,42,569,1,0,0,0.0,150,1985
794,4/5/2022,3656,5,2,592,41,568,2,0,0,0.0,150,1987
795,5/5/2022,3658,4,3,592,41,566,0,0,0,0.0,150,1987
796,6/5/2022,3660,3,3,593,41,564,0,0,0,0.0,150,1987
797,7/5/2022,3662,1,4,593,41,563,0,0,0,0.0,150,1987
798,8/5/2022,3662,0,4,594,41,563,0,0,0,0.0,150,1987
799,9/5/2022,3663,2,4,592,41,562,2,0,0,0.0,150,1989
800,10/5/2022,3663,3,4,592,41,561,1,0,0,0.0,150,1990
801,11/5/2022,3663,3,1,594,41,562,0,0,0,0.0,150,1990
802,12/5/2022,3665,1,3,593,41,561,0,0,0,0.0,150,1990
803,13/5/2022,3666,2,3,593,41,559,1,0,0,0.0,150,1991
804,14/5/2022,3668,3,3,592,41,557,1,0,0,0.0,150,1992
805,15/5/2022,3669,3,3,591,41,557,0,0,0,0.0,150,1992
806,16/5/2022,3672,2,5,590,41,554,1,0,0,0.0,150,1993
807,17/5/2022,3670,3,6,591,41,553,3,0,0,0.0,150,1996
808,18/5/2022,3670,4,6,591,41,552,1,0,0,0.0,150,1997
809,19/5/2022,3674,4,5,586,41,554,0,0,0,0.0,150,1997
810,20/5/2022,3678,2,5,587,41,551,0,0,0,0.0,150,1997
811,21/5/2022,3680,2,7,584,41,550,2,0,0,0.0,150,1999
812,22/5/2022,3679,3,5,585,41,551,1,0,0,0.0,150,2000
813,23/5/2022,3685,2,4,585,41,547,0,0,0,0.0,150,2000
814,24/5/2022,3687,2,3,584,41,547,0,0,0,0.0,150,2000
815,25/5/2022,3688,0,5,583,41,547,0,0,0,0.0,150,2000
816,26/5/2022,3690,2,4,582,41,545,2,0,0,0.0,150,2002
817,27/5/2022,3690,2,3,580,41,548,0,0,0,0.0,150,2002
818,28/5/2022,3690,3,3,578,41,549,1,0,0,0.0,150,2003
819,29/5/2022,3694,1,5,577,41,546,0,0,0,0.0,150,2003
820,30/5/2022,3694,3,5,577,41,544,2,0,0,0.0,150,2005
821,31/5/2022,3692,6,5,577,41,543,3,0,0,0.0,150,2008
822,1/6/2022,3693,6,7,576,41,541,2,0,0,0.0,150,2010
823,2/6/2022,3696,4,8,577,41,538,0,0,0,0.0,150,2010
824,3/6/2022,3696,6,6,576,41,539,2,0,0,0.0,150,2012
825,4/6/2022,3698,4,5,577,41,539,0,0,0,0.0,150,2012
826,5/6/2022,3700,2,8,575,41,538,1,0,0,0.0,150,2013
827,6/6/2022,3701,2,8,575,41,537,0,0,0,0.0,150,2013
828,7/6/2022,3701,2,6,578,41,536,1,0,0,0.0,150,2014
829,8/6/2022,3701,2,6,578,41,536,1,0,0,0.0,150,2015
830,9/6/2022,3701,3,6,579,41,534,2,0,0,0.0,150,2017
831,10/6/2022,3701,4,5,580,41,533,2,0,0,0.0,150,2019
832,11/6/2022,3701,5,6,579,41,532,2,0,0,0.0,150,2021
833,12/6/2022,3703,7,5,577,41,531,2,0,0,0.0,150,2023
834,13/6/2022,3706,7,4,577,41,529,0,0,0,0.0,150,2023
835,14/6/2022,3708,8,5,575,41,527,2,0,0,0.0,150,2025
836,15/6/2022,3710,5,6,577,41,525,0,0,0,0.0,150,2025
837,16/6/2022,3711,4,6,578,41,524,1,0,0,0.0,150,2026
838,17/6/2022,3714,3,4,579,41,523,0,0,0,0.0,150,2026
839,18/6/2022,3713,4,3,580,41,523,1,0,0,0.0,150,2027
840,19/6/2022,3712,4,5,580,41,522,2,0,0,0.0,150,2029
841,20/6/2022,3712,3,4,581,41,523,0,0,0,0.0,150,2029
842,21/6/2022,3715,2,4,579,41,523,0,0,0,0.0,150,2029
843,22/6/2022,3717,3,2,581,41,520,1,0,0,0.0,150,2030
844,23/6/2022,3719,4,2,579,41,519,1,0,0,0.0,150,2031
845,24/6/2022,3722,2,4,577,41,518,0,0,0,0.0,150,2031
846,25/6/2022,3724,1,3,578,41,517,0,0,0,0.0,150,2031
847,26/6/2022,3726,1,4,578,41,514,1,0,0,0.0,150,2032
848,27/6/2022,3725,3,3,577,41,515,2,0,0,0.0,150,2034
849,28/6/2022,3727,3,2,576,41,515,0,0,0,0.0,150,2034
850,29/6/2022,3729,3,2,575,41,514,0,0,0,0.0,150,2034
851,30/6/2022,3730,4,2,573,41,514,1,0,0,0.0,150,2035
852,1/7/2022,3730,4,3,572,41,514,1,0,0,0.0,150,2036
853,2/7/2022,3730,2,4,572,41,515,0,0,0,0.0,150,2036
854,3/7/2022,3733,2,4,572,41,512,0,0,0,0.0,150,2036
855,4/7/2022,3735,0,5,573,41,510,0,0,0,0.0,150,2036
856,5/7/2022,3739,0,4,573,41,507,0,0,0,0.0,150,2036
857,6/7/2022,3741,1,4,572,41,505,1,0,0,0.0,150,2037
858,7/7/2022,3740,2,3,572,41,506,1,0,0,0.0,150,2038
859,8/7/2022,3740,2,3,572,41,506,1,0,0,0.0,150,2039
860,9/7/2022,3739,3,3,570,41,508,1,0,0,0.0,150,2040
861,10/7/2022,3737,4,3,571,41,508,2,0,0,0.0,150,2042
862,11/7/2022,3741,2,5,571,41,504,0,0,0,0.0,150,2042
863,12/7/2022,3743,2,5,569,41,504,0,0,0,0.0,150,2042
864,13/7/2022,3747,1,5,568,41,502,0,0,0,0.0,150,2042
865,14/7/2022,3746,2,5,568,41,502,1,0,0,0.0,150,2043
866,15/7/2022,3747,4,5,567,41,500,3,0,0,0.0,150,2046
867,16/7/2022,3750,3,5,567,41,498,0,0,0,0.0,150,2046
868,17/7/2022,3751,2,5,568,41,497,0,0,0,0.0,150,2046
869,18/7/2022,3753,3,3,569,41,495,1,0,0,0.0,150,2047
870,19/7/2022,3753,2,4,568,41,496,0,0,0,0.0,150,2047
871,20/7/2022,3755,2,3,568,41,495,0,0,0,0.0,150,2047
872,21/7/2022,3756,2,4,567,41,494,1,0,0,0.0,150,2048
873,22/7/2022,3757,1,3,568,41,494,0,0,0,0.0,150,2048
874,23/7/2022,3757,3,3,567,41,493,2,0,0,0.0,150,2050
875,24/7/2022,3758,2,4,567,41,492,0,1,1,0.0,151,2050
876,25/7/2022,3764,2,4,563,41,490,0,0,1,0.0,151,2050
877,26/7/2022,3765,2,4,561,41,491,0,0,1,0.0,151,2050
878,27/7/2022,3767,2,3,561,41,490,0,0,1,0.0,151,2050
879,28/7/2022,3775,1,3,555,41,489,0,0,1,0.0,151,2050
880,29/7/2022,3780,2,3,552,41,486,1,0,1,0.0,151,2051
881,30/7/2022,3783,2,3,552,41,483,1,0,1,0.0,151,2052
882,31/7/2022,3786,2,2,551,41,482,0,0,1,0.0,151,2052
883,1/8/2022,3789,1,2,550,41,481,0,0,0,0.0,151,2052
884,2/8/2022,3793,0,3,549,41,478,0,0,0,0.0,151,2052
885,3/8/2022,3795,1,3,546,41,478,1,0,0,0.0,151,2053
886,4/8/2022,3794,3,3,545,41,478,2,0,0,0.0,151,2055
887,5/8/2022,3796,2,3,545,41,477,0,0,0,0.0,151,2055
888,6/8/2022,3796,2,2,546,41,477,0,0,0,0.0,151,2055
889,7/8/2022,3797,4,2,544,41,476,2,0,0,0.0,151,2057
890,8/8/2022,3799,2,3,545,41,474,0,0,0,0.0,151,2057
891,9/8/2022,3802,0,4,544,41,473,0,0,0,0.0,151,2057
892,10/8/2022,3803,0,4,541,41,475,0,0,0,0.0,151,2057
893,11/8/2022,3803,1,4,540,41,475,1,0,0,0.0,151,2058
894,12/8/2022,3804,3,4,538,41,474,2,0,0,0.0,151,2060
895,13/8/2022,3807,4,2,537,41,473,1,0,0,0.0,151,2061
896,14/8/2022,3808,4,3,533,41,475,1,0,0,0.0,151,2062
897,15/8/2022,3808,5,4,528,41,478,2,0,0,0.0,151,2064
898,16/8/2022,3810,4,4,527,41,478,0,0,0,0.0,151,2064
899,17/8/2022,3815,3,5,527,41,473,1,0,0,0.0,151,2065
900,18/8/2022,3814,5,5,526,41,473,2,0,0,0.0,151,2067
901,19/8/2022,3814,4,4,528,41,473,0,0,0,0.0,151,2067
902,20/8/2022,3817,4,5,526,41,471,1,0,0,0.0,151,2068
903,21/8/2022,3818,6,4,524,41,471,2,0,0,0.0,151,2070
904,22/8/2022,3819,4,5,523,41,472,0,0,0,0.0,151,2070
905,23/8/2022,3822,3,5,521,41,472,0,0,0,0.0,151,2070
906,24/8/2022,3823,3,5,519,41,473,1,0,0,0.0,151,2071
907,25/8/2022,3828,2,6,516,41,471,0,0,0,0.0,151,2071
908,26/8/2022,3829,2,6,514,41,472,0,0,0,0.0,151,2071
909,27/8/2022,3831,2,3,516,41,471,1,0,0,0.0,151,2072
910,28/8/2022,3833,2,2,515,41,471,0,0,0,0.0,151,2072
911,29/8/2022,3835,2,2,514,41,470,0,0,0,0.0,151,2072
912,30/8/2022,3837,2,2,512,41,470,0,0,0,0.0,151,2072
913,31/8/2022,3840,2,3,510,41,468,1,0,0,0.0,151,2073
914,1/9/2022,3844,2,3,506,41,468,0,0,0,0.0,151,2073
915,2/9/2022,3846,3,3,504,41,467,1,0,0,0.0,151,2074
916,3/9/2022,3854,3,3,498,41,465,0,0,0,0.0,151,2074
917,4/9/2022,3853,6,2,498,41,464,3,0,0,0.0,151,2077
918,5/9/2022,3858,4,2,497,41,462,0,0,0,0.0,151,2077
919,6/9/2022,3863,4,2,494,41,460,0,0,0,0.0,151,2077
920,7/9/2022,3865,2,3,493,41,460,0,0,0,0.0,151,2077
921,8/9/2022,3865,2,4,490,41,462,1,0,0,0.0,151,2078
922,9/9/2022,3866,4,4,488,41,461,2,0,0,0.0,151,2080
923,10/9/2022,3866,3,6,485,41,463,1,0,0,0.0,151,2081
924,11/9/2022,3870,1,8,482,41,462,0,0,0,0.0,151,2081
925,12/9/2022,3872,2,7,480,41,462,1,0,0,0.0,151,2082
926,13/9/2022,3873,3,6,481,41,460,2,0,0,0.0,151,2084
927,14/9/2022,3873,5,6,480,41,459,2,0,0,0.0,151,2086
928,15/9/2022,3875,4,7,477,41,460,0,0,0,0.0,151,2086
929,16/9/2022,3877,6,6,477,41,457,2,0,0,0.0,151,2088
930,17/9/2022,3877,6,4,479,41,457,1,0,0,0.0,151,2089
931,18/9/2022,3878,5,6,477,41,457,1,0,0,0.0,151,2090
932,19/9/2022,3879,5,7,475,41,457,1,0,0,0.0,151,2091
933,20/9/2022,3878,7,8,472,41,458,4,0,0,0.0,151,2095
934,21/9/2022,3878,8,5,472,41,460,2,0,0,0.0,151,2097
935,22/9/2022,3878,8,7,470,41,460,2,0,0,0.0,151,2099
936,23/9/2022,3874,13,5,470,41,461,5,0,0,0.0,151,2104
937,24/9/2022,3875,10,8,469,41,461,0,0,0,0.0,151,2104
938,25/9/2022,3877,9,9,467,41,461,1,0,0,0.0,151,2105
939,26/9/2022,3876,9,10,467,41,461,2,0,0,0.0,151,2107
940,27/9/2022,3880,7,10,466,41,460,0,0,0,0.0,151,2107
941,28/9/2022,3883,7,12,463,41,458,3,0,0,0.0,151,2110
942,29/9/2022,3884,5,13,464,41,457,1,0,0,0.0,151,2111
943,30/9/2022,3885,7,9,465,41,457,2,0,0,0.0,151,2113
944,1/10/2022,3889,6,9,463,41,456,1,0,0,0.0,151,2114
945,2/10/2022,3886,8,8,463,41,458,3,0,0,0.0,151,2117
946,3/10/2022,3884,10,10,462,41,457,6,0,0,0.0,151,2123
947,4/10/2022,3885,9,11,459,41,459,1,0,0,0.0,151,2124
948,5/10/2022,3884,10,10,459,41,460,3,0,0,0.0,151,2127
949,6/10/2022,3883,13,8,461,41,458,4,0,0,0.0,151,2131
950,7/10/2022,3887,10,10,461,41,455,1,0,0,0.0,151,2132
951,8/10/2022,3884,15,10,460,41,454,6,0,0,0.0,151,2138
952,9/10/2022,3884,14,13,458,41,454,2,0,0,0.0,151,2140
953,10/10/2022,3885,13,15,456,41,454,3,0,0,0.0,151,2143
954,11/10/2022,3888,10,16,455,41,454,1,0,0,0.0,151,2144
955,12/10/2022,3887,11,16,452,41,457,2,0,0,0.0,151,2146
956,13/10/2022,3886,11,16,453,41,457,4,0,0,0.0,151,2150
957,14/10/2022,3886,13,15,453,41,456,3,0,0,0.0,151,2153
958,15/10/2022,3888,8,17,456,41,454,2,0,0,0.0,151,2155
959,16/10/2022,3891,7,15,455,41,455,1,0,0,0.0,151,2156
960,17/10/2022,3893,7,14,454,41,455,2,0,0,0.0,151,2158
961,18/10/2022,3895,7,14,451,41,456,1,0,0,0.0,151,2159
962,19/10/2022,3898,7,14,449,41,455,3,0,0,0.0,151,2162
963,20/10/2022,3897,9,15,447,41,455,4,0,0,0.0,151,2166
964,21/10/2022,3898,9,16,445,41,455,2,0,0,0.0,151,2168
965,22/10/2022,3900,12,14,444,41,453,4,0,0,0.0,151,2172
966,23/10/2022,3900,13,13,444,41,453,3,0,0,0.0,151,2175
967,24/10/2022,3898,16,11,444,40,455,4,0,0,0.0,151,2179
968,25/10/2022,3898,17,9,445,40,455,2,0,0,0.0,151,2181
969,26/10/2022,3894,18,9,446,40,457,4,0,0,0.0,151,2185
970,27/10/2022,3894,16,12,447,40,455,3,0,0,0.0,151,2188
971,28/10/2022,3896,9,19,446,40,454,1,0,0,0.0,151,2189
972,29/10/2022,3890,16,18,447,40,453,8,0,0,0.0,151,2197
973,30/10/2022,3889,17,15,451,40,452,3,0,0,0.0,151,2200
974,31/10/2022,3891,17,16,451,40,449,3,0,0,0.0,151,2203
975,1/11/2022,3890,15,18,449,40,452,2,0,0,0.0,151,2205
976,2/11/2022,3891,13,18,449,40,453,3,0,0,0.0,151,2208
977,3/11/2022,3890,14,16,453,40,451,4,0,0,0.0,151,2212
978,4/11/2022,3896,12,15,452,40,449,0,0,0,0.0,151,2212
979,5/11/2022,3897,8,17,451,40,451,1,0,0,0.0,151,2213
980,6/11/2022,3894,10,17,453,40,450,6,0,0,0.0,151,2219
981,7/11/2022,3893,9,14,458,40,450,2,0,0,0.0,151,2221
982,8/11/2022,3895,8,11,459,40,451,1,0,0,0.0,151,2222
983,9/11/2022,3897,9,10,455,40,453,1,0,0,0.0,151,2223
984,10/11/2022,3899,6,12,455,40,452,1,0,0,0.0,151,2224
985,11/11/2022,3897,7,11,457,40,452,3,0,0,0.0,151,2227
986,12/11/2022,3901,6,11,454,40,452,1,0,0,0.0,151,2228
987,13/11/2022,3903,5,12,451,40,453,2,0,0,0.0,151,2230
988,14/11/2022,3902,6,9,454,40,453,1,0,0,0.0,151,2231
989,15/11/2022,3902,7,6,452,40,457,1,0,0,0.0,151,2232
990,16/11/2022,3908,5,6,449,40,456,0,0,0,0.0,151,2232
991,17/11/2022,3908,5,6,450,40,455,1,0,0,0.0,151,2233
992,18/11/2022,3908,5,5,451,40,455,1,0,0,0.0,151,2234
993,19/11/2022,3905,7,5,452,40,455,3,0,0,0.0,151,2237
994,20/11/2022,3906,7,6,450,40,455,1,0,0,0.0,151,2238
995,21/11/2022,3906,8,7,448,40,455,3,0,0,0.0,151,2241
996,22/11/2022,3906,7,7,448,40,456,1,0,0,0.0,151,2242
997,23/11/2022,3910,6,9,443,40,456,2,0,0,0.0,151,2244
998,24/11/2022,3916,6,5,441,40,456,0,0,0,0.0,151,2244
999,25/11/2022,3915,6,6,439,40,458,2,0,0,0.0,151,2246
1000,26/11/2022,3912,9,7,438,40,458,5,0,0,0.0,151,2251
1001,27/11/2022,3917,9,5,438,40,455,0,0,0,0.0,151,2251
1002,28/11/2022,3919,9,4,439,40,453,1,0,0,0.0,151,2252
1003,29/11/2022,3922,10,3,436,40,453,1,0,0,0.0,151,2253
1004,30/11/2022,3925,8,6,431,40,454,1,0,0,0.0,151,2254
1005,1/12/2022,3925,7,8,429,40,455,2,0,0,0.0,151,2256
1006,2/12/2022,3925,8,8,427,40,456,1,0,0,0.0,151,2257
1007,3/12/2022,3927,6,8,429,40,454,1,0,0,0.0,151,2258
1008,4/12/2022,3926,3,13,427,40,455,2,0,0,0.0,151,2260
1009,5/12/2022,3929,3,10,427,40,455,1,0,0,0.0,151,2261
1010,6/12/2022,3929,5,8,426,40,456,2,0,0,0.0,151,2263
1011,7/12/2022,3933,4,9,423,40,455,1,0,0,0.0,151,2264
1012,8/12/2022,3934,4,8,422,40,456,0,0,0,0.0,151,2264
1013,9/12/2022,3936,4,7,424,40,453,1,0,0,0.0,151,2265
1014,10/12/2022,3934,5,9,423,40,453,3,0,0,0.0,151,2268
1015,11/12/2022,3931,9,7,425,40,452,4,0,0,0.0,151,2272
1016,12/12/2022,3932,10,4,426,40,452,2,0,0,0.0,151,2274
1017,13/12/2022,3931,11,3,427,40,452,1,0,0,0.0,151,2275
1018,14/12/2022,3933,8,5,425,40,453,0,0,0,0.0,151,2275
1019,15/12/2022,3933,6,7,425,40,453,0,0,0,0.0,151,2275
1020,16/12/2022,3934,3,10,425,40,452,2,0,0,0.0,151,2277
1021,17/12/2022,3933,4,8,427,40,452,2,0,0,0.0,151,2279
1022,18/12/2022,3933,6,9,425,40,451,3,0,0,0.0,151,2282
1023,19/12/2022,3933,9,6,427,40,449,3,0,0,0.0,151,2285
1024,20/12/2022,3932,9,7,427,40,449,2,0,0,0.0,151,2287
1025,21/12/2022,3934,9,8,427,40,446,1,0,0,0.0,151,2288
1026,22/12/2022,3935,8,6,429,40,446,0,0,0,0.0,151,2288
1027,23/12/2022,3934,8,7,428,40,447,2,0,0,0.0,151,2290
1028,24/12/2022,3935,8,7,426,40,448,1,0,0,0.0,151,2291
1029,25/12/2022,3936,6,8,426,40,448,0,0,0,0.0,151,2291
1030,26/12/2022,3936,5,7,428,40,448,1,0,0,0.0,151,2292
1031,27/12/2022,3935,4,8,428,40,449,2,0,0,0.0,151,2294
1032,28/12/2022,3938,4,6,428,40,448,1,0,0,0.0,151,2295
1033,29/12/2022,3941,5,5,426,40,447,1,0,0,0.0,151,2296
1034,30/12/2022,3943,4,5,427,40,445,0,0,0,0.0,151,2296
1035,31/12/2022,3941,5,5,427,40,446,2,0,0,0.0,151,2298
1036,1/1/2023,3943,2,7,426,40,446,0,0,0,0.0,151,2298
1037,2/1/2023,3946,3,5,425,40,445,1,0,0,0.0,151,2299
1038,3/1/2023,3948,3,6,422,40,445,1,0,0,0.0,151,2300
1039,4/1/2023,3949,4,5,422,40,444,1,0,0,0.0,151,2301
1040,5/1/2023,3949,4,6,421,40,444,1,0,0,0.0,151,2302
1041,6/1/2023,3948,5,5,422,40,444,2,0,0,0.0,151,2304
1042,7/1/2023,3948,7,5,421,40,443,2,0,0,0.0,151,2306
1043,8/1/2023,3946,9,5,420,40,444,3,0,0,0.0,151,2309
1044,9/1/2023,3947,3,11,419,40,444,0,0,0,0.0,151,2309
1045,10/1/2023,3947,3,11,419,40,444,1,0,0,0.0,151,2310
1046,11/1/2023,3946,8,9,417,40,444,5,0,0,0.0,151,2315
1047,12/1/2023,3944,8,11,417,40,444,2,0,0,0.0,151,2317
1048,13/1/2023,3946,8,10,416,40,444,1,0,0,0.0,151,2318
1049,14/1/2023,3945,11,11,415,40,442,5,0,0,0.0,151,2323
1050,15/1/2023,3945,10,13,411,40,445,2,0,0,0.0,151,2325
1051,16/1/2023,3946,8,15,411,40,444,1,0,0,0.0,151,2326
1052,17/1/2023,3946,8,14,413,40,443,1,0,0,0.0,151,2327
1053,18/1/2023,3946,7,15,413,40,443,2,0,0,0.0,151,2329
1054,19/1/2023,3945,9,15,413,40,442,4,0,0,0.0,151,2333
1055,20/1/2023,3947,7,14,414,40,442,0,0,0,0.0,151,2333
1056,21/1/2023,3937,15,12,415,40,445,10,0,0,0.0,151,2343
1057,22/1/2023,3937,16,6,419,40,446,1,0,0,0.0,151,2344
1058,23/1/2023,3938,13,9,417,40,447,1,0,0,0.0,151,2345
1059,24/1/2023,3939,11,12,414,40,448,2,0,0,0.0,151,2347
1060,25/1/2023,3939,10,13,413,40,449,1,0,0,0.0,151,2348
1061,26/1/2023,3933,12,15,414,40,450,6,0,0,0.0,151,2354
1062,27/1/2023,3929,15,16,415,40,449,5,0,0,0.0,151,2359
1063,28/1/2023,3927,17,12,419,40,449,3,0,0,0.0,151,2362
1064,29/1/2023,3929,16,12,419,40,448,2,0,0,0.0,151,2364
1065,30/1/2023,3931,15,10,419,40,449,1,0,0,0.0,151,2365
1066,31/1/2023,3930,9,16,421,40,448,2,0,0,0.0,151,2367
1067,1/2/2023,3929,8,17,422,40,448,4,0,0,0.0,151,2371
1068,2/2/2023,3927,10,16,424,40,447,3,0,0,0.0,151,2374
1069,3/2/2023,3928,11,10,429,40,446,1,0,0,0.0,151,2375
1070,4/2/2023,3929,11,12,428,40,444,3,0,0,0.0,151,2378
1071,5/2/2023,3930,8,13,429,40,444,2,0,0,0.0,151,2380
1072,6/2/2023,3932,6,15,430,40,441,2,0,0,0.0,151,2382
1073,7/2/2023,3929,12,13,430,40,440,6,0,0,0.0,151,2388
1074,8/2/2023,3931,11,15,428,40,439,2,0,0,0.0,151,2390
1075,9/2/2023,3932,9,14,431,40,438,0,0,0,0.0,151,2390
1076,10/2/2023,3937,10,12,427,40,438,1,0,0,0.0,151,2391
1077,11/2/2023,3935,10,13,428,40,438,3,0,0,0.0,151,2394
1078,12/2/2023,3938,8,14,427,40,437,0,0,0,0.0,151,2394
1079,13/2/2023,3937,9,14,427,40,437,3,0,0,0.0,151,2397
1080,14/2/2023,3937,5,15,430,40,437,0,0,0,0.0,151,2397
1081,15/2/2023,3938,4,14,432,40,436,1,0,0,0.0,151,2398
1082,16/2/2023,3941,5,11,432,40,435,1,0,0,0.0,151,2399
1083,17/2/2023,3940,4,12,431,40,437,2,1,1,0.0,152,2401
1084,18/2/2023,3941,4,10,433,40,436,2,0,1,0.0,152,2403
1085,19/2/2023,3941,4,8,435,40,436,0,0,1,0.0,152,2403
1086,20/2/2023,3943,4,8,434,40,435,0,0,1,0.0,152,2403
1087,21/2/2023,3946,2,5,435,40,436,0,0,1,0.0,152,2403
1088,22/2/2023,3946,4,5,434,40,435,3,0,1,0.0,152,2406
1089,23/2/2023,3948,3,7,433,40,433,1,0,1,0.0,152,2407
1090,24/2/2023,3949,4,7,431,40,433,1,0,1,0.0,152,2408
1091,25/2/2023,3951,4,8,432,40,429,2,0,1,0.0,152,2410
1092,26/2/2023,3952,4,7,431,40,430,0,0,1,0.0,152,2410
1093,27/2/2023,3953,2,7,433,40,429,0,0,0,0.0,152,2410
1094,28/2/2023,3954,2,6,432,40,430,0,0,0,0.0,152,2410
1095,1/3/2023,3954,2,6,432,40,430,1,0,0,0.0,152,2411
1096,2/3/2023,3957,2,4,432,40,429,0,0,0,0.0,152,2411
1097,3/3/2023,3961,2,4,429,40,428,1,0,0,0.0,152,2412
1098,4/3/2023,3963,2,3,429,40,427,0,0,0,0.0,152,2412
1099,5/3/2023,3966,1,3,427,40,427,0,0,0,0.0,152,2412
1100,6/3/2023,3968,0,3,425,40,428,0,0,0,0.0,152,2412
